#######################################################
#                                                     #
# # # # # # # # # # # # # # # # # # #=#=#=#=# # # # # #
#                                                     #
# # # # # # # # # # # # # # # # # # # # # # # # # # # #
#                                                     #
# # # # # # # # # # # # # # # # # # # # # # # # # # # #
#                                                     #
# # #o# # # # # # # # # # # # # # # # # # # # #o# # # #
#                                                     #
# # # # # # # # # # # # # # # # # # # # # # # # # # # #
#.....................................................#
# # # # # # # # # # # # # # # # # # # # # # # # # # # #
#.....................................................#
# # # # # # # # # # # # # # # # # # # # # # # # # # # #
#.....................................................#
# # # # # # # # # # # # # # # # # # # # # # # # # # # #
#                                                     #
# # # # # # # # # # # # #%# # # # # # # # # # # # # # #
#                                                     #
# # # # # # # # # # # # # # # # # # # # # # # # # # # #
#.....................................................#
# # # # # # # # # # # # # # # # # # # # # # # # # # # #
#.....................................................#
# # # # # # # # # # # # # # # # # # # # # # # # # # # #
#.....................................................#
# # # # # # # # # # # # # # # # # # # # # # # # # # # #
#                                                     #
# # # # # # # # # # # # # # # # # # # # # # # # # # # #
#                                                     #
# # #o# # # # # # # # # # # # # # # # # # # # #o# # # #
#                                                     #
# # # # # # # # # # # # # # # # # # # # # # # # # # # #
# \                                                   #
#######################################################
