#######################################################
#                                                     #
# # # # # # # # # # # # # # # # # # # # # # # # # # # #
#                                                     #
# # # # # # # # # # # # # # # # # # # # # # # # # # # #
#                                                     #
# # # # # # # # # # # # # # # # # # # # # # # # # # # #
#                                                     #
# # # # # # # # # # # # # # # # # # # # # # # # # # # #
#                                                     #
# # # # # # # # # # # # # # # # # # # # # # # # # # # #
#                                                     #
# # # # # # # # # # # # # # # # # # # # # # # # # # # #
#                                                     #
# # # # # # # # # # # # # # # # # # # # # # # # # # # #
#                                                     #
# # # # # # # # # # # # # # # # # # # # # # # # # # # #
#                                                     #
# # # # # # # # # # # # # # # # # # # # # # # # # # # #
#                                                     #
# # # # # # # # # # # # # # # # # # # # # # # # # # # #
#                                                     #
# # # # # # # # # # # # # # # # # # # # # # # # # # # #
#                                                     #
# # # # # # # # # # # # # # # # # # # # # # # # # # # #
#                                                     #
# # # # # # # # # # # # # # # # # # # # # # # # # # # #
#                                                     #
# # # # # # # # # # # # # # # # # # # # # # # # # # # #
#                                                     #
# # # # # # # # # # # # # # # # # # # # # # # # # # # #
#                                                     #
# # # # # # # # # # # # # # # # # # # # # # # # # # # #
#                                                     #
#######################################################
