#######################
#=#=#=#=#.............#
#.#.#.#.#.###########.#
#.#.#.#.#.###########.#
#.#.#.#.#.#####.......#
#.#.#.#.#.##### #####.#
#.#.#.#.#.#####%#####.#
#.#.#.#.#.#####.#####.#
#.#.#.#.#.#####.#####.#
#.........#...........#
###########.#########.#
#..\...o..............#
#######################