#######################
#=#= =#=#...#.........#
#.#.#.#.#.#.#.#######.#
#.#.#.#.#.#.#.#######.#
#.#.#.#.#.#.#.#.......#
#.#.#.#.#.# # # #######
#.#.#.#.#.# # # #.....#
#.#.#.#.#.# # # #.###.#
#...#.#.#.#   #   #...#
###.#.#.#.###########.#
###.#.....#...........#
###########.#########.#
#..\..o..%............#
#######################