#########
#......=#
#.# ###-#
#.  o  .#
#.### #.#
#\......#
#########
