#########
#......=#
#.# ###%#
#.  o  .#
#.### #.#
#\......#
#########
