########
#= =   #
########
#o\o..%#
########
